# # # # # # #
# # # S # # #
# # # . # # #
# . . . . . # 
# . # # # . #
# . # . # . #
# . # . # . #
# . . . . . #
# # # # . . #
# # . . . # #
# # . # # # #
# . . . . . # 
# . # # # . #
# . # F # . #
# . # . # . #
# . . . . . #
# # # # # # #