# S # # # #
# . . . . #
# # . # # #
# . . . . F
# # # . # #
# # # # # #